9
7
H-C------
-YYYYYYY-
-YYYYYYY-
-YYYYYYY-
-YYYYYYY-
-YYYYYYY-
---------