9
5
H--Y---Y-
-Y------C
--Y------
----Y--Y-
---------
